###############
#    f       5#
# 2  #####    #
#     3    #  #
#   #######  4#
#6#           #
# ##########  #
#s  1   3    ##
@@@@@@@@@@@@@@@