###############
#           15#
#  f        23#
#  ####    #66#
#4   3  #  #@@#
#   ###### ####
#6#       4   #
#1##########  #
# s       2  ##
@@@@@@@@@@@@@@@